11111111
10000011
100001N1
11111111