NO img/WallNoEXISTEN.png
SO img/WallS.png
WE img/WallW.png
EA img/WallE.png

F 220,126, 62
C 62,120, 220

11111111
10000001
10000001
10000001
100E0001
10000001
10000001
11111111