NO img/WallN.png
SO img/WallS.png
WE img/WallW.png
EA img/WallE.png

F 220,126, 62
C 62,120, 220

    111111111111111
111110000000000001
1100000000000011111
 1110000000000001111
 1110000000000001111
 11100000W0000001111
   1110000000000001111
  11000000000000111
 1110000000000001111
   111111000011111111
   111111110000111111
   11111000011111
      111111111
