NO img/WallN.png
SO img/WallS.png
WE img/WallW.png
EA img/WallE.png

F 220,126, 62
C 62,120, 220

    11111111111111111111111111111111111111111
111110000000000000000000000000000000000000001
11000000000000000000000000001000000000000011111
 11100001000000000000000000000000000000000001111
 11100000000000000000000010000000000000000001111
 111000010000000000W0000000000000000000000001111
   11100000000000000000000001000000000000000001111
  110000100000000000000000000000000000000000111
 1110000000000000000000001111111111111111111111
   111111000000000000011111111
   111111110000000000000111111
   11111000000000000000000000011111
      100000000000000000011111111
  11000000000000000000000111
 1110000000000000000000001111
   111111000000000000011111111
   111111110000000000000111111
   11111000000000000000000000011111
      1111100000000011111111111111
  11000000000000000000000111
 1110000000000000000000001111
   111111000000000000011111111
   111111110000000000000111111
   11111000000000000000000000011111
      111111000000000000000000111
  1100000000000000000000011111111
 111000000000000000000000111111111
   111111000000000000000000000011111111
   111111110000000000000000000000111111
   11111000000000000000000000011111
      11111111111111111111111111111
