NO img/WallN.png
SO img/WallS.png
WE img/WallW.png
EA img/WallE.png

F 220,126, 62
C 62,120, 220

11111111111111
1000S010000000
10000001000000
10000000000001
11111111111111
