NO img/WallN.png
SO img/WallS.png
WE img/WallW.png
EA img/WallE.png

F 220,126, 62
C 62,120, 220

    111111111111111
11111000S0000000001
1100000000000011111
 1110000000000001111
   11111111111111
